56 42
                      ############
         ########     #..........#    ########
         #......#######..........######......#
         #.................@.................#
         #......#######..........######......#
         ########     #..........#    ########
                      #####..#####
                          #..#
                          #..#
                          #..#
                          #..#
                          #..#
                          #..#
                          #..#
                          #..#
                          #..#
                          #..#
############          #####..#####          ############
#..........#          #..........#          #..........#
#..........############..........############..........#
#......................................................#
#......................................................#
#..........############..........############..........#
#..........#          #..........#          #..........#
############          #####..#####          ############
                          #..#
                          #..#
                          #..#
                          #..#
                          #..#
                          #..#
                          #..#
                          #..#
                          #..#
                          #..#
                      #####..#####
                      #..........#     ########
                      #..........#######......#
                      #.......................#
                      #..........#######......#
                      #..........#     ########
                      ############