25 23
#############
#...........#############
#.......................#
#.......................#
#.......................#
#................####...#
#................#......#
#................#......#
#................#......#
#................#......#
#................#......#
######..############..###
     #..#           ##
      #..#
      ##..#      ########
  #####..##      #......#
  #.......#      #......#
  #.......#      #......#
  #.......########......#
  #.....................#
  #.......########...@..#
  #.......#      #......#
  #########      ########
